...........
..^^^^^....
.....^^^...
.....^^....
...........
...........
