......^.............
..^^^^^.....^.^.....
......^^..^^^..^....
.....^^^^^^..^.^^.^.
.....^^.^^.......^^.
....^.^...^^^^.^....
..^.........^....^..
....^^^..^.^...^....
.....^..............
